R 848 480

NO textures/wall_no.xpm
SO textures/wall_so.xpm


WE textures/wall_we.xpm
EA textures/wall_ea.xpm

S textures/sprite_1.xpm

F 184,113,39


C 51,198,227

111111
1000N 
1110 1
111111
